0000000000000000
0000000000000000
0000000000000000
0000111111000000
0000100001000000
0000103331100000
0000100122111000
0000110022301000
0000010400001000
0000011111111000
0000000000000000
0000000000000000
0000000000000000
0000000000000000
