0000000000000000
0000000000000000
0000000000000000
0000001111110000
0000001000011100
0000001030000100
0000111030110100
0000122203000100
0000122231301100
0000111101030100
0000000100400100
0000000111111100
0000000000000000
0000000000000000
