0000000000000000
0000000000000000
0000000000000000
0000011110000000
0000012210000000
0000110211000000
0000100321000000
0001103001100000
0001001330100000
0001004000100000
0001111111100000
0000000000000000
0000000000000000
0000000000000000
