0000000000000000
0000000000000000
1111110001111100
1000011101002100
1003030101222100
1010030111002100
1003330003042100
1110030031002100
0010031301222100
0011000001002100
0001111111111100
0000000000000000
0000000000000000
0000000000000000
