0000001111111110
0000001000000010
0000001010101010
0000001003031010
1111111000300010
1221001103031010
1220001103030010
1221001101111110
1221010303010000
1220000030010000
1001110401110000
1111011111100000
0000000000000000
0000000000000000
