0000000000000000
0000000000000000
0001111100000000
0001400100000000
0001033101110000
0001030101210000
0001110111210000
0000110000210000
0000100010010000
0000100011110000
0000111110000000
0000000000000000
0000000000000000
0000000000000000
