0000000000000000
0000000111111000
0001111120001000
0001001221101000
0001003220001000
0001001021011000
0011101131001000
0010300003301000
0010131001001000
0014001111111000
0011111000000000
0000000000000000
0000000000000000
0000000000000000
