0000000000000000
0011111111100000
0010001000111000
0010303023001000
0010121212101000
0010323432301000
0010121212101000
0010032030301000
0011111110001000
0000000011111000
0000000000000000
0000000000000000
0000000000000000
0000000000000000
