0000000000000000
0000000000000000
0001111111110000
0001000110010000
0001010303010000
0001005210010000
0001101242110000
0001131115111000
0001000000001000
0001000110101000
0001111110001000
0000000011111000
0000000000000000
0000000000000000
