1111111100000000
1000000100000000
1033000111000000
1003033301111100
1101102220000110
0101412221113010
0101032220000010
1101032223010110
1001111101110100
1000000300030100
1111111111100100
0000000000111100
0000000000000000
0000000000000000
