1111111100000000
1000100100000000
1222330111111100
1222100000000100
1222131111110100
1222100000010110
1111103031010010
0000103030301010
0000100103004010
0000103303111110
0000100000100000
0000111111100000
0000000000000000
0000000000000000
