0000000000000000
1111100000000000
1000101111100000
1000111000100000
1022200033111110
1222200100100011
1021011110131001
1100001000003301
1000100000331001
1000000010403011
1000100001100010
1111110001111110
0000011111000000
0000000000000000
