0000000000000000
0000000000000000
0000000000000000
0001111111000000
0001042221000000
0001000111100000
0011130000100000
0010001310100000
0010301000100000
0010001111100000
0011111100000000
0000000000000000
0000000000000000
0000000000000000
