0000000000000000
0011111111100000
0010000000100000
0013330333100000
0012222222100000
0012221222100000
0013333333100000
0010004000100000
0011111111100000
0000000000000000
0000000000000000
0000000000000000
0000000000000000
0000000000000000
