0000000000000000
0000000000000000
0000000000000000
0000111100000000
0001100100000000
0001430100000000
0001130110000000
0001103010000000
0001230010000000
0001225210000000
0001111110000000
0000000000000000
0000000000000000
0000000000000000
