0000000000000000
0000000000000000
0001111111000000
0001202021000000
0001033301000000
0001234321000000
0001033301000000
0001202021000000
0001111111000000
0000000000000000
0000000000000000
0000000000000000
0000000000000000
0000000000000000
