0000000000000000
0000000000000000
0000000000000000
0000111110000000
0000104010000000
0000122210000000
0000133311000000
0000100001000000
0000100001000000
0000111111000000
0000000000000000
0000000000000000
0000000000000000
0000000000000000
