0000000000000000
0000111111100000
0111100000100000
0100021110100000
0101010000110000
0101030312010000
0101005001010000
0102130301010000
0110000101011100
0010111200004100
0010000011000100
0011111111111100
0000000000000000
0000000000000000
