0000000000000000
0000000000000000
0000000000000000
0000001111111100
0000001100104100
0000001000100100
0000001303030100
0000001031100100
0000111030101100
0000122222001100
0000111111111100
0000000000000000
0000000000000000
0000000000000000
