0000000000000000
0000000000000000
0000000000000000
0001111111110000
0001001100010000
0001000300010000
0001301110310000
0001012221010000
0011012221011000
0010300300301000
0010000010401000
0011111111111000
0000000000000000
0000000000000000
